{
 "id": "biome_floor__sun_bleached",
 "tilesW": 2,
 "tilesH": 2,
 "palette": [
  "#0b0d10",
  "#6b5842",
  "#8a7658",
  "#a68a5b",
  "#c2a879",
  "#d9c49a",
  "#4a3c2c"
 ],
 "frames": {
  "idle/0": [
   "33333333333333333333333333333333",
   "33333353333333313333333333335333",
   "33334443333333333333533331333333",
   "33364443133335333333333444333333",
   "33544433333333333333134453333333",
   "31333333333333344333333333333333",
   "33333313333333444333333333333223",
   "33333333335333443333336333332221",
   "33333333332233333333333333332233",
   "33333133322233335331333333333333",
   "33333333322333333333333332223333",
   "33335333333333333333333322223333",
   "33133334433333333333333322235333",
   "33333344433353333333533333333133",
   "33333344333133335333333333333333",
   "33333333533333363333333353333333",
   "33333333333333333334443333333333",
   "33313333333333133344443333333335",
   "33333223333333333344433333333333",
   "33332233313333333333313333333333",
   "33533333336333333353333333333313",
   "33333333333331333333333333333333",
   "33344333333333333222333333533333",
   "33444333333333332222333333333333",
   "33443353333333332223333333344333",
   "33333331333333533333333133443333",
   "33333333335333333333333333333353",
   "33333633333332233333333313333333",
   "33333333333322333333333333333333",
   "31333333333333333133335333313633",
   "33333333333333333333333333333333",
   "33333333333333333333333333333333"
  ]
 }
}
