{
 "id": "biome_floor__sun_bleached",
 "tilesW": 2,
 "tilesH": 2,
 "palette": [
  "#0b0d10",
  "#2a1f14",
  "#6b5842",
  "#a68a5b",
  "#d9c49a",
  "#f97316",
  "#8a7658"
 ],
 "frames": {
  "idle/0": [
   "11111111111111111111111111111111",
   "13333333133333331333333313333333",
   "13443333133333331353333313333333",
   "13343333134433331333333313333333",
   "13333333134333331333333313333223",
   "13333333133333331333333313333333",
   "13333333133333331332333313333333",
   "13333333133333331333333313333333",
   "11111111111111111111111111111111",
   "33331333333313333333133333331333",
   "33331333333313333333166333331333",
   "33331355333313333333166333331333",
   "33331335333313333333133333331333",
   "33331333333313333333133333331333",
   "33331333333313333333133333331333",
   "33331333333313333333133333331333",
   "11111111111111111111111111111111",
   "13333333133333331333333313333333",
   "13333333133333441333333313333333",
   "15533333133333441333333313663333",
   "15533333133333331333333313663333",
   "13333333133333331333333313333333",
   "13333333133333331333333313333333",
   "13333333133333331333333313333333",
   "11111111111111111111111111111111",
   "33331333333313333333133333331333",
   "33331333344313333333133333331333",
   "33331333334313333333136633331333",
   "33331333333313333533136632331333",
   "33321333333313333333133333331333",
   "33321333333313333333133333331333",
   "33331333333313333333133333331333"
  ]
 }
}
