{
 "id": "biome_floor__default",
 "tilesW": 2,
 "tilesH": 2,
 "palette": [
  "#0b0d10",
  "#1c2024",
  "#2b3036",
  "#3d444c",
  "#55606a",
  "#8a6a4a",
  "#c77a3a"
 ],
 "frames": {
  "idle/0": [
   "12202222222321222222223222122222",
   "22120222242222212222222222321222",
   "22220222322222222123242222222212",
   "23422012222232222221222322422222",
   "22222022122222243222212222232225",
   "22222205231222222222322122222223",
   "22322202222213222222222231222222",
   "21222230222222122322222222213222",
   "22212220223222221222232222222422",
   "22232102222422322216222223222221",
   "22224201222222222232122222222322",
   "32222222212322222222221222222222",
   "22223222222122232242222212320222",
   "12222222322221222223222222102232",
   "23122222222232612222222322201222",
   "26221322222222223122222522032212",
   "22222212232222222221322222022223",
   "22322242122223222222212240222222",
   "22222232221222222322222120223222",
   "22222222223212222222232221022222",
   "21232622222224122222222223012242",
   "22212223222222221232222222222122",
   "32242122222322222512223222222221",
   "22223221222222232222122222322222",
   "22222222312222222223421222222232",
   "23222222222132222222222312222222",
   "12222322422221223222222222135222",
   "22122222232222242222322222221223",
   "22321222226223222122222232222212",
   "22422212222222222321222224223222",
   "22222222123222222222212222222222",
   "22232222221222322222222123222222"
  ]
 }
}
