{
 "id": "biome_floor__catacombs",
 "tilesW": 2,
 "tilesH": 2,
 "palette": [
  "#0b0d10",
  "#1c2024",
  "#33383e",
  "#4a5058",
  "#6b7280",
  "#d8d3c4",
  "#8a8f98",
  "#4a2818"
 ],
 "frames": {
  "idle/0": [
   "66666663641222222221222422222216",
   "66666666661222022221222222222216",
   "66666666661402222221222227224214",
   "66666600000022622221227722722216",
   "46666666661222222261627772222216",
   "66666666661222223221222222222216",
   "66666666661222222221222223222216",
   "66666666661222222221222222222216",
   "11111111111111111111111111111111",
   "22222216666366666166666622212222",
   "22223216666666666166666622212222",
   "22222216666666666136666622212262",
   "22222216666666666163666622212222",
   "22222216666666666166664624212222",
   "22222216666364666166666622312222",
   "22222216666366664166666622212222",
   "22222616666666666166666622212222",
   "11111111111111111111111111111111",
   "22212222222212224222022122222222",
   "22212222222212222222202026322222",
   "22212222222212222222222102222222",
   "22212222222212224222222120222222",
   "22212222222212222222222123022222",
   "22212222226212222222222122022222",
   "22212222222212222242222122222222",
   "11111111111111111111111511111111",
   "66666666612222222212222255222133",
   "66666666612222222212222222522133",
   "66636666612222226212222226222133",
   "66666666612222232212222222222133",
   "66666666612222222212223222222143",
   "66666666612222222213222222222133"
  ]
 }
}
