{
 "id": "biome_floor__biome_mox8bles",
 "tilesW": 2,
 "tilesH": 2,
 "palette": [
  "#0b0d10",
  "#1c2024",
  "#33383e",
  "#4a5058",
  "#6b7280",
  "#3a2a1c",
  "#5c4530",
  "#7a5a3a",
  "#8a6540",
  "#c98a3f",
  "#f97316",
  "#e6e8eb"
 ],
 "frames": {
  "idle/0": [
   "11111101111111111111111101111111",
   "11111110111111111111111110111111",
   "11100110111111111111100111011111",
   "11079811011111111111079811011111",
   "1107a61101111111111107a611101111",
   "11106011101111111111106011110111",
   "11111122201111111111111111111111",
   "11111122011111111111111111111111",
   "11111111011111111122111111111111",
   "11111110111001111122111111111111",
   "11111110110798111122111111100111",
   "111111011107a6111111111111034311",
   "11111101111060111111111111043411",
   "11111111111111111111111111103011",
   "11111111111111111111111111111111",
   "11111111111111111111111111111111",
   "12211111111111111111111111111111",
   "12211111111111111111111111111111",
   "12211111111111111111111001122211",
   "11111111111111111111110798122211",
   "111110011111112221111107a6111100",
   "11110343111111222111111060110011",
   "11110434111111111111111110001111",
   "11111030111111111111111001111111",
   "11111111110011111111000111111111",
   "11111111001100011100111111111111",
   "11111100111111100011111111111111",
   "11111011111001111110011122211111",
   "11100111110798111103431122211111",
   "100111111107a6111104341111111111",
   "01111111111060111110301111111111",
   "11111111111111111111111111111111"
  ]
 }
}
