{
 "id": "biome_floor__catacombs",
 "tilesW": 2,
 "tilesH": 2,
 "palette": [
  "#0b0d10",
  "#1c2024",
  "#33383e",
  "#4a5058",
  "#6b7280",
  "#d8d3c4",
  "#8a8f98",
  "#4a2818"
 ],
 "frames": {
  "idle/0": [
   "00000000000000000000000000000000",
   "02323223232332200222232122222220",
   "03221221322332200122122731222120",
   "02202233222422200273777212122220",
   "02220222213242200227777222121220",
   "03222022222212200232772227222220",
   "03221202200033200322222271222220",
   "03222320021222100222121122122320",
   "01322222202221200323221222211210",
   "02223121222323300221222222223220",
   "02223323231222200322231213232220",
   "02321423322223100212221223322310",
   "02223241222222200223231222122220",
   "02221122222233200323222222223230",
   "02212111222222100222213222122210",
   "00000000000000000000000000000000",
   "00000000000000000000000000000000",
   "02222223332223200132222122222220",
   "02222223221122100212211232323220",
   "02232222232323300222255555213220",
   "02222222122552200222555555532120",
   "03212223222555100232550605522120",
   "02223323255562300222555555532220",
   "02222232536622100332255555212120",
   "02222225362222300221220202221230",
   "03225552623121100222222221222220",
   "03255566122221200210222212221230",
   "02255612332222200301121122123220",
   "02232231212221200202322131222220",
   "02223322122222100022122132223330",
   "01221122322222300122122122222320",
   "00000000000000000000000000000000"
  ]
 }
}
