{
 "id": "biome_floor__frozen",
 "tilesW": 2,
 "tilesH": 2,
 "palette": [
  "#05070a",
  "#0b2733",
  "#163b4d",
  "#2c6478",
  "#9fd8e6",
  "#e8f6fa",
  "#134152"
 ],
 "frames": {
  "idle/0": [
   "22222226222222222222222222222222",
   "22222222222222222222222222222222",
   "22222222222222222233221222222222",
   "22221112222223222333322222222222",
   "22215111221222222233222222222322",
   "22211111222222222222222222222222",
   "22221112222222222222211222202222",
   "22222222222222222222141122022222",
   "22222222222222222222111100222222",
   "22222222223322222222211026222222",
   "22222222233332322222220222222222",
   "22222222233332222223222222222222",
   "62222222223322222222222222222222",
   "22222222222222222222222222222222",
   "22222222222122222222222222233322",
   "22220222222222222222222222343362",
   "22222002222222222222222222333332",
   "22222230022222222222222222233322",
   "22223222200222222222222222222222",
   "22222222222222222222222222222222",
   "22222222222221112222262222221222",
   "22222222222215111222222222222222",
   "22233222222211111222222222222222",
   "22353322222211111222222222222222",
   "22333322222221112212222221122222",
   "22233122222222222222222211412222",
   "22222222622222222222222221122221",
   "22222222222222262222222222222222",
   "22222222222222222222222222226222",
   "21222222222222222222222322222222",
   "22222222222222222222222222222222",
   "22222222222222222222222222222222"
  ]
 }
}
