{
 "id": "biome_floor__alien_core",
 "tilesW": 2,
 "tilesH": 2,
 "palette": [
  "#05070a",
  "#111827",
  "#1c2128",
  "#f97316",
  "#fdba74",
  "#6b7280",
  "#3a2410",
  "#fff2df"
 ],
 "frames": {
  "idle/0": [
   "11111111111111111011111111111111",
   "11111111111111111011222222222211",
   "115.2222222222111011222222225211",
   "11222202222222111011222222222011",
   "11022222222222111011222222220211",
   "11200222222222110111222225202211",
   "11222022222222110111222200022211",
   "11225202222222110111222202222211",
   "11222220022222110111222022222211",
   "11222222201166660666110111111111",
   "11222222211166666666111111111111",
   "11222222211663333336611111111111",
   "11111111166663333336666111111111",
   "11111111166333444433366111111111",
   "11111111166334774443366111111111",
   "00000111166334774443366111111111",
   "11111000006334444443360000011111",
   "11111111166334444443366111100000",
   "11111111166333444433366111111111",
   "11111111166663333336666111111111",
   "11111111111663333336611222222211",
   "12222222211166666666111222222211",
   "12222222201166660666110222222211",
   "12222222022111110122222022222211",
   "12222220222111110122222202522211",
   "12222502222111110122222220222211",
   "12222202222111110122222220022211",
   "12222002222111101122222222202211",
   "12520222222111101122222222225211",
   "12202222222111101122222222222211",
   "11111111111111101111111111111111",
   "11111111111111101111111111111111"
  ]
 }
}
